fahrenheit	f
celsius	c
kilometer	km
meter	m
centimeter	cm
millimeter	mm
hectare	ha
mile	mi
square meter	m²
square kilometer	km²
foot	ft
percent	%
hertz	hz
kilowatt	kw
horsepower	hp
milligram	mg
kilogram	kg
gigahertz	ghz
kilohertz	khz
megahertz	mhz
pound	ld
volt	v
hour	h
mega coulomb	mc
second	s
nanometer	nm
revolution per minute	rpm
minute	min
milli ampere	mA
per cent	%
kilo watt hour	kwh
cubic meter	m³
mile per hour	mph
tera watt	tw
milli volt	mv
megawatt	mw
micrometer	μm
inch	\"
terabyte	tb
c c	cc
gram	g
dalton	da
atmosphere	atm
ohm	ω
decibel	db
peta second	ps
ounce	oz
hecto liter	hl
microgram	µg
petagram	pg
gigabyte	gb
kilobit	kb
electron volt	ev
megabyte	mb
kilobyte	kb
kilobit per second	kbps
megabit per second	mbps
stone	st
kilo liter	kl
tera joule	tj
kilo volt	kv
mega volt	mv
kilonewton	kn
megameter	mm
astronomical unit	au
yard	yd
radian	rad
lumen	lm
hecto second	hs
mole	mol
giga pascal	gpa
milliliter	ml
gigawatt	gw
mega ampere	ma
knot	kt
kilogram force	kgf
nano gram	ng
nanosecond	ns
mega siemens	ms
bar	bar
giga liter	gl
microsecond	μs
deci ampere	da
pascal	pa
deci second	ds
milli second	ms
deci meter	dm
cubic deci meter	dm³
atomic mass unit	amu
megabit	mb
mega farad	mf
becquerel	bq
petabit	pb
square millimeter	mm²
square centimeter	cm²
square mile	sq mi
square foot	sq ft
kilopascal	kpa
candela	cd
tera liter	tl
mega second	ms
megapascal	mpa
peta meter	pm
peta byte	pb
giga watt hour	gwh
kilo calory	kcal
gray	gy
sievert	sv
hundredweight	cwt
